"a" = (/turf/closed/wall/mineral/titanium,/area/shuttle/supply)
"b" = (/turf/open/floor/mineral/titanium/blue,/area/shuttle/supply)
"c" = (/obj/machinery/light{dir = 1},/turf/open/floor/mineral/titanium/blue,/area/shuttle/supply)
"d" = (,/area/shuttle/supply)
"e" = (/obj/machinery/conveyor{dir = 4; id = "QMLoad2"},,/turf/open/floor/plating,/area/shuttle/supply)
"f" = (,/turf/open/floor/plating,/area/shuttle/supply)
"g" = (/obj/machinery/light{dir = 8},/turf/open/floor/mineral/titanium/blue,/area/shuttle/supply)
"h" = (,,/obj/machinery/light{dir = 4},/turf/open/floor/mineral/titanium/blue,/area/shuttle/supply)
"i" = (,,/turf/open/floor/plating,/area/shuttle/supply)
"j" = (/obj/machinery/conveyor{dir = 8; id = "QMLoad"},,/turf/open/floor/plating,/area/shuttle/supply)
"k" = (/turf/closed/wall/mineral/titanium/interior,/area/shuttle/supply)
"l" = (/obj/structure/window/reinforced{dir = 1},/obj/structure/shuttle/engine/heater,/turf/open/floor/plating/airless,/area/shuttle/supply)
"m" = (/turf/template_noop,/area/template_noop)
"n" = (/obj/structure/shuttle/engine/propulsion/burst/left,/turf/open/floor/plating/airless,/area/shuttle/supply)
"o" = (/obj/structure/shuttle/engine/propulsion,/turf/open/floor/plating/airless,/area/shuttle/supply)
"p" = (/obj/structure/shuttle/engine/propulsion/burst/right,/turf/open/floor/plating/airless,/area/shuttle/supply)

(1,1,1) = {"
aaaaaaa
abbcbba
abbbbba
abdddbe
abdddbf
agdddha
abdddbi
abdddbj
abbbbba
akbbbka
aalllaa
mnooopm
"}
